R 1280 960
NO ./wall-N.xpm
SO ./wall-S.xpm
WE ./wall-W.xpm
EA ./wall-E.xpm

S ./sprite-2.xpm
F 50,200,80
C 150,210,255

        1111111111111111111111111
        1000000000110000000000001
        1011000001110000002000001
        1001000000000000000000001
111111111011000001110000000000001
100000000011000001110111111111111
11110111111111011100000010001
11112111111111011101010010001
11020200110101011100000010001
10202020220202001100000010001
12020202020202001101010010001
1100N00111010101111101111000111
11110111 1110101 101111010001
11111111 1111111 111111111111
