R 320 280
NO ./wall-1.xpm
SO ./wall-2.xpm
WE ./wall-3.xpm
EA ./wall-4.xpm

S ./sprite-1.xpm
F 50,200,80
C 150,210,255

11111111111111111111111111111111111111111111111111111111111111111111111111111111111111111111111111111111111111111111111111111111
10000200020000000000000000000000000000020000000000000000000001000000020200000200002020000001000000000000001100001000000000000001
10000000000002000000020000000002020000000010002000101000000001000000000000100000000000100001000001200200000000020000100000000001
12000000021000000000000000000000020002020000000000100000000000001000002000000001001000010000001000000000000020000010000000000001
1020001000000000000000100100000000000000010000000010000S000200000000000000000000100000002000102002000000200000000000000200000011
10000000000002010001000000002001000000002000000000100100001100000001000000000000200100000100010000000000010000000100100020000001
10000000000000000000000000000000000000000000210000011100000000100000000000000020020000020002000000201000201210000000000020010011
10000200020020000002000000000000000100000000000000000000000020000000000201000000000000200010000000000000000000000101000021000201
10020002000000000000000010100001002200100100000002002000000000000000200002000000000000000200000000000000000200000002000220000001
10001020110000010000000000000000000100100010000000020101210010000000012002000101200000000000000000000100010010000000200000000211
10002000000001000000000000200000000020000000000020002112001010000010000000100000000000001000100000000000000000000000010002000021
10000001000000000200001000000100000201000101000000000002020010000000000011100010000000212000210000200000000000000000000000000001
10000000000000000000000000000022000000010000000000000000002000000000000010000000000100001100100200001000000001001000000010000001
10000002100000000000000000010200000000000010000001000000000010001000000200010200200000000002002201000100200000001012000000001021
10020000002000000100000100000000000000000000100200102000000200201000000000000000002001000001000000000000000000010000000000020001
10100000000000000000000101000000100000000011100020000000001000000000010000020000000001000011200000002000000001000010000002010011
10000000020000000020000000001200000010100000000000100000000000000000000000100010000000000000000200000000002000000000001000010001
10200000100000010010000000220020000000000002000000000000002000000000000000000120020000000100000000000200000002000022001000001101
10000000020000000000002000200011000001000000000100000020020000010000000200102200000022200200000000000000000000000000000000000001
10000002010000000000100000000000000000000000000000200000000000100000000000000020000000010000000000010201002000000000000020000001
11000000010200100000000000002200000000000202000200000000000000000012000020100000100001010000000000001200000000001001000000000001
10000000200000000000000000002000220200000000000010000000001000000000000002000021000000000000000000000200010102010000000200020001
10100000000000000000000010000200001001000002200000000000000000001000210000101110000002000012000020000100020200000000001002020101
10000000200000000000000000200000010000022010000100200000000000000200010000000000002100200000000000001000200000001000100000000001
10200000000002200000200000000112010000000020200002000000000000000000200010000000000000002010000000000001010000000001000010011001
10000000000000020000020020000000000001100020000001002002020002000200012000000000000000000000000200000000001010121000100000002201
10010000000020100100000000020000000000000000021000001000000120001011000200010102000001000000000000200000000000002000000002000001
10000001000020000000000000000000000000000202000000012002200000200000000000220000010000000000000020000000200000200000000200000201
10000000000200000000002000020100020000002020010000000000000000000000000000000000002000210100000000020000000000101000000001200001
12010000000020000010020010002000000000000000000000000100002000100000200000022000000000001002100011100010100002020120002000000001
11000100000001000000021000202001000000100020000001000000000000000000100000022202001110000000100000010020020000000001000000020001
11000020000000100100000000000120001000010000000110000000001001010022001001000000000020000000000000000100000100100001000120000211
10020000200000000000000100202021000010000002000020000000000000100000010001000010000020000200010000002000100201000112200000000001
10000100000200001000000001001000000020020000012000020002000000000200000200000000200000100000000210010000000000000000000200000101
10211000001020001000000000000000020000000000000000000100002110000000200000001020210000002002120000000001000000000100000000020001
11000000000000000000001200000020000001100000000200000000002000101110000000000100020002000000100000000000000000010000000020000021
11000001020000020020100000000000000022010120000000000000011100000100000000002000000100000000010000010000000001000000001000200201
10000000020100020200010000000000000002000002000100000000000200000000000120020021200011100100000201002000000020010000002000000001
10001010000000000000100000102002200000000000000000000200100000002000000001000000002001000200000000012000000100000022002000200201
10000001000002000012000001000210000000000220000001000000000010000000000011200000010010000002200120120000000000120010002101000001
12001000000000000000000000000010000000000100000001002100100000000002202000000000000020200001201001000001000002000000002000010001
10000020002000000102120010000000020000000100000000010000002000000000020000000000001001000000000200100001001020000000000001220021
10000100010000200000000001010000100001000200002010000000000000100000000000000000000000000010000000000000000220000220000020010201
12011200120001000000000000100200000010000001010000001100020200000000000000000000200000002000002000000101020001000000000001001001
10110000000000000000000002000000002022000000000000020000000002001002000000000000002010000000000001000000000002000000000111000001
10000000200100000000001000000000001002000000100000000200022221001002012020020000000002000000000020010010020000000100000002000001
10020000000001200000000000000000000020010000100002000000100200010010002120000000000000002000000000000000010000002000000000200001
12002000000000100000000200010000000000000020002001002102000000000000000000000000001000000001100000000000020000002000200002000001
10000020000000000000000020000100000000010000010000002000000000000000000000002000000010000000010002100000001000000000000101020001
10000000000020000000101000001200020000000000200000002020200200100000001000001000000000000000000000000000001200000001100000020101
10000012100000000000220020010000100002000000100000020200002001002200000202010000000020000001000200000000002020000012100000200001
10200000100020200210000200000020000020000000000200200020000000000000200000000000200020002000000000000001000020010000000000000001
12000000200001000000021000000010200100010001020100200000100000000000000102210000010000000000002000110000000010000002000010000001
12000000020200000000000001000000100002001000000002002100000000000000020000010000000200000000020000000000000000000000100000000201
10020000002001000010010100020002000000000000000100120000000000000000100020020000000200011000000000200020000020000001000000020001
10002002000000000200000200000000000000000000000001002010000001120011000000000000000000000000021001200001100000000022000100001011
10010000000000000000100002000010000000000010000000010000100002000000020000000000000000000000001100000200000010000000000000000001
10000000021000000100020000200100000002000000001010000221020200201000000001000000000100200010020001000120000002000000200200000001
10100000002100001000100020020001001000202000000000100200000000000020000000000022000000000001000002000000000000200000000000000001
10000020000202100000000002001000000000020002000000220000000200010000000000010000000001000000001020000000020000020100000000001001
10001000022000000000020000000001001000000000200200000000001000000010000000000100000001000000002100000000000000001200000200010101
12101000000100000000020220000000000002100100000200000000000100000000100210000001102001020000000000000000100000000110000000000101
10000000000000000000001000002000000000000102000000020010021000000000200000000000000000000020000000000200000000021100002000000001
10000000000000020000000010000021000000000000200010021000000020001000000000000120000020000220100000011010000000101000000000000001
10100001100022000000002000000201000000000000002000202020000000000000001000021000100020000000000100010001000001011000002000001011
10000000000000010110000000000000000000000001000000000000000000010000201000000100000000001000000200100000220000000000000001001001
10010001000000002020000200002010002000020000020000002000010201000000000000000000020020001000000000000000000000000001000000010001
10200000000000000000002000010002001002001000000000010000000000001001002000000000010020000000000000000000000000002000000021002001
10000002000000000000000000000202002020000000000000000100000000002000110020000010000000000000000010000000000000020000000000002201
10001000000000100000000000000020000000000000000000000020001000000000000000100000000000000002000000000000000000010000000000000001
10100000000000000200000000102000000100010002002000000000000010000000010001000100201010200000001001000000000020000000200000000001
10000000000010000100000010000020000000102001011000000100000000000000000002000000000101000010000000000000100000000000000000000001
10000000100011000200202100000001000000000000000000000000000020000000110022020002200020000020100010000000011000000002000001010001
10000000021100000001101000100000020000002000002201010102000000000010020000000000000000000000000000020000100202000000101000000201
10010000000000002000020000000000100200010012000000010022021000100000200001000000000000000000002000000000000101002000200000000001
10200020000000100000002000000020000000102100200020000000000000000000001000100100000000000000000000001000000200010000002001000101
10000000000000002020000001010000000000100001000000000010000100002000001000000020010020000000100001002000000001000000020000000001
10000000000000020020001002000020100000100000000000000000000020000000000002000102000000000020001000000000100000000000000200201001
10100002001001200001000000000000010000000000020000000000120001002002200100002002000000000100000010002000000000000000200010110001
10000000000202010000000000022000000200000000000000000000000000000000100000000000202001100000000000000000000000000000100002100001
10000000000101000000210000020000000200002000000001020000000000000000000000000110001020120000000020022000000000000000000000000001
10000001002020020000020100000000000200000010020100002110100000000000000000000010000010010020020000010000021001002001000000001001
10000000000002100002000002000200000000010020000001000000000000002212200000001000000000010000020220100000000000020002000000000001
12000000000200001000200002001001000000000000000000000002000020020000000000000000000000000200001000000000000200010000000000000001
10000201000100002000000002200200000100000000000000021000010000000000000200000000220100002000100000000000000100000010001010000201
10000010010000000201000010001001200000020000100021000000122002000000000000000001000010002000000000000000000000000000000000000201
10000000020010000102000000001000102100000010020101100200000000002000000000200000012000000000000001200000000000002100010000001201
11010000000020001000000000010000002020020100200000000000001000020002000000000011000000000000010000000000001110000000000100000001
10201000000000000000000010120220010000000100000000020001000000000001200100000000001000100000000100001000200000200000000201000001
10000002200000000000000100100000000000000000000001000000002010020000000010000000000200200000000000000000001000000000000000200011
10022000100000000000100000000000001002020000000100002100200000002000020000102012000000000000000000000000000000002000100000010021
10111102020100002000000100001000020000200020001000000000000100110000000010010000000000000002000021000000000000000001010010000001
10100100000000000000010002010010000000100000010000100000120020001000000000000000000000000000000000200000010000000000000100200201
10000000001000000020100000100010000020000000000000000010010000000100002000211000000000101000100020202200000000000000020200000001
10001000010010002000001000200000000000010100000100000000002000100000000000210000000000000200011000010000000000100000020000000001
10000020000000000002000000000000000000001000020100000000200000000000000000000000010000000010000010000012002000000000000010001001
10200000000010001000000000010020010001200000000021000001000000000000100000100000000000021000020000000010000000000000001000000001
11110000001000120002000020001000000200000001010010020021020000000200020000000000200000000000000102000000200020000000000010000001
11200000000000000000022120020012000000211000200000000000120002000012200000200000002000200000002000100100000100001201200200000001
10000000000201020000000201000020000000000000001000010001001100100010000000200000000101000000000000000000011000000000000200000001
10200000000000000100000000000100200010000000002000100010000000100000000022200000100000000020000100000001010020000000000000001001
10000000001000200010000200000000100000000000200020000000002020000000000000001000000000020000000000000100000100020000000000000001
10002000000001000000000000002200002000000000000000210000000020001000000000000100000000000000000000000010100000000000010000000001
10000000000000000000000010020002100100000000020000000000200000000100002020000220200200000100010000000000000000000000000000000001
10020000000000000002200000000001010002000020100001000000102000000110002100020000200000000100000000000000010010002001000010000001
11100002012020000000000000022002000000200000012000000001200002200000000000202020000022000010000000001021000001020022000000002001
10000000100000021000000000000020000000002210000002000100012100200000000000000000002000000000000000000000000000201000000000210001
10200000000100000000200000000100120000200200000000000001002002001000002010000000220001000200000000000000000000001000001000000001
10000000001200001000000020220000000000000100000010000020100000000000001020000020000002100000101000001000110000000100002100100001
10000000000020000000200000002010220100000020002000000100002201002000000000022100000000020000000000020000010000000000200000102001
11202002000002010010100001000000100000000000001200000000000000001000020000010000001000001000000000000020000000020100002110000001
10000000000101010100000000102000000010000002000000020000000000000000200000000000000000002000000000000101010020021000022100000001
10222100000000200002000100000000020100110201000020000000010000000000000000000001011000000000000001200000000000000202100000010001
10000000001020010200010000000000010000000000010200002110000000000000102000000000001100200000000010000002200000002010020100000001
10000000000000022000000000000000000000000000000000020001020001000010020000100000012002000000002000200100200011000000000000020001
10000010000000001000020100000020001000000000000000020000010000000000000000200020002000000000102001000000001000200000002000000001
10200010000000101001000201000000000010010000000000000000000010000000000010000000000002010010001020000010000010000000000000002001
10200000000000000010000100000000010001000000020000000000001000002100011202000000000000100210200000000000000000020000000200000001
12000000000100200020000001000000020202000200100000000100000000022000200000020000000120002000002000000000000000000000100022000001
10000100020000000020000000000010002000010000101200000200002000000001200000020000000000000000000200000000200020000002000020020101
10001000000000000010000100000002000100000000000000000000000000000200002000002000000000100212000210000200000000000000000000120011
10000020120120001000000000100000000000200000000000000000010001001000020000001000020000010000000200020200000010000000020200000101
10001000210002220000002000000000002000101010020010000000000200000000020000000200022002000000000000000000002000000000000000000201
10000000020000020020000002000000000002000000000000020100200000000000120001000110000010000000000100000001000000000002002000000001
10001000000000001001000001100200000200000000000000000000100010000020200000000000000010000211000020000002000000200000102002000011
10000000002210001000000210000000100000000000000000200000000000000000000200000010000000000200000000000000000022200000000000002001
10000001100200200120000000000100000001001000000010000100000000000000001000100000000000002000010000000000020000000200020002000001
11111111111111111111111111111111111111111111111111111111111111111111111111111111111111111111111111111111111111111111111111111111
