R 1920 1080
NO ./wall-1.xpm
SO ./wall-2.xpm
WE ./wall-3.xpm
EA ./wall-4.xpm

S ./sprite-1.xpm
F 50,200,80
C 150,210,255

1111111111111111111111111
1S10000000000000000000101
1010111111111111101110101
1010000000000000100010001
1011111111111111111011101
1000001000000000001010001
1111101011111111101011111
1000101000000010001000001
1110101111111010111111101
1000100000100010100000001
1011111110101110111011101
1000000010100010100010001
1011101110101010101110111
1000100000101010101010101
1110111111111010101010101
1010100010000010001000001
1010101010111111111111101
1010101000100000000000101
1010101111101111111110101
1010100010001000000000101
1010111010111011111111101
1010001000001000000010001
1011101111101111111011111
1000101000100000001000001
1010101010111111111111101
1010000010000000000000021
1111111111111111111111111
