R 1920 1080
NO ./wall-1.xpm
SO ./wall-2.xpm
WE ./wall-3.xpm
EA ./wall-4.xpm

S ./sprite-1.xpm
F 50,200,80
C 150,210,255

11111111111111111111111111111111111111111111111111
10000000000000000000000000000000000000000000000001
10000000000000000000002000000000000000000000000001
10000000000000000000002000000000000000000000000001
10000000000000000000002000000000000000000000000001
10000000000000000000002000000000000000000000000001
10000000000000000000002000000000000000000000000001
10000000000000000000002000000000000000000000000001
10000000000000000000002000000000000000000000000001
10000000000000000000002000000000000000000000000001
10000000000000000000002000000000000000000000000001
10000000000000000000002000000000000000000000000001
10000000000000000000002000000000000000000000000001
10000000000000000000002000000000000000000000000001
10000000000000000000002000000000000000000000000001
10000000000000000000002000000000000000000000000001
10000000000000000000002000000000000000000000000001
10000000000000000000002000000000000000000000000001
10000000000000000000002000000000000000000000000001
10000000000000000000002000000000000000000000000001
10000000000000000000002000000000000000000000000001
10000000000000000000002000000000000000000000000001
10000000000000000000000222222222222222222220000001
100000000000000000000N0000000000000000000000000001
10000000000000000000000000000000000000000000000001
10000000000000000000000000000000000000000000000001
10000000000000000000000000000000000000000000000001
10000000000000000000000000000000000000000000000001
10000000000000000000000000000000000000000000000001
10000000000000000000000000000000000000000000000001
10000000000000000000000000000000000000000000000001
10000000000000000000000000000000000000000000000001
10000000000000000000000000000000000000000000000001
10000000000000000000000000000000000000000000000001
10000000000000000000000000000000000000000000000001
10000000000000000000000000000000000000000000000001
10000000000000000000000000000000000000000000000001
10000000000000000000000000000000000000000000000001
10000000000000000000000000000000000000000000000001
10000000000000000000000000000000000000000000000001
11111111111111111111111111111111111111111111111111
