R 1920 1080
NO ./wall-1.xpm
SO ./wall-2.xpm
WE ./wall-3.xpm
EA ./wall-4.xpm

S ./sprite-1.xpm
F 50,200,80
C 150,210,255

        1111111111111111111111111
        1000000000110000000000001
        1011000001110000002000001
        10010E0000000000000000001
111111111011000001110000000000001
100000000011000001110111111111111
11110111111111011100000010001
11110111111111011101010010001
11000000110101011100000010001
10002000000000001100000010001
10000000000000001101010010001
1100000111010101111101111020111
11110111 1110101 101111010001
11111111 1111111 111111111111
